-20
15
-12
16
000000000000000000000000000000000000
000000000000000000000000000000000000
000000000000000111111110000000000010
000000000000000011111110000000000000
000000000000000011111110000000000000
000000000000000011111110000000000000
000000000000000011111110000000000000
000010000000000011111110000000000000
000000000000000000000000000000000000
000000000000000000000000000000000000
000000000000000000000000000000000000
000000000000000000000000100000001000
000000000000000000000000000000000000
000000000000000000000000000000000000
000000000000000000100000000000000000
111111100000000000000000000000000000
111111100000000000000000000000000000
111111100000000000000000000000000000
111111100000000000000000000000000000
111111100000000000000000000000000000
111111100000000000000000000000000000
111111100000000000000000000000000000
000000000000000000000001111111000000
000000000000000000000001111111000000
000000000000000000000001111111100000
000000000000000000000001111111000000
000000000000000000000001111111000000
000000100000000000000001111111000000
000000000000000000000001111111000000
